71, 71, 71, 71, 71, 71, 71, 68, 68, 68, 71, 71, 71, 71, 71, 71,
71, 71, 71, 71, 71, 71, 72, 68, 68, 68, 71, 71, 71, 71, 71, 71,
71, 71, 71, 72, 68, 68, 68, 68, 68, 68, 70, 71, 71, 71, 71, 71,
71, 71, 72, 68, 68, 68, 68, 68, 68, 68, 68, 70, 71, 71, 71, 71,
71, 72, 68, 68, 68, 98, 68, 68, 68, 68, 68, 68, 70, 71, 71, 71,
68, 68, 68, 68, 68, 68, 68, 68, 68, 68, 68, 68, 68, 70, 71, 71,
63, 64, 68, 68, 68, 68, 68, 68, 68, 98, 68, 68, 68, 68, 103, 103,
71, 71, 68, 68, 98, 68, 68, 68, 68, 68, 68, 68, 68, 68, 71, 103,
71, 71, 68, 68, 68, 68, 68, 68, 68, 68, 68, 68, 68, 68, 103, 103,
71, 71, 63, 63, 63, 63, 63, 63, 63, 63, 63, 63, 63, 63, 103, 103,
103, 103, 103, 103, 103, 103, 103, 103, 103, 103, 103, 103, 103, 103, 103, 103