71, 71, 71, 71, 71, 71, 71, 71, 71, 71, 71, 71, 71, 71, 71, 71,
71, 71, 71, 71, 71, 71, 71, 71, 71, 71, 71, 71, 71, 71, 71, 71,
71, 72, 68, 68, 68, 68, 68, 68, 68, 68, 68, 70, 71, 71, 71, 71,
72, 68, 68, 99, 68, 99, 68, 68, 68, 68, 99, 68, 70, 71, 71, 71,
68, 68, 68, 68, 68, 68, 68, 68, 68, 68, 68, 68, 68, 70, 71, 71,
68, 68, 68, 99, 68, 99, 68, 68, 68, 68, 99, 68, 68, 68, 71, 71,
68, 68, 68, 68, 68, 68, 68, 68, 68, 68, 68, 68, 68, 68, 71, 103,
64, 68, 68, 99, 68, 99, 68, 68, 68, 68, 99, 0, 68, 68, 71, 103,
71, 64, 68, 68, 68, 68, 68, 68, 68, 0, 0, 68, 68, 62, 63, 103,
71, 71, 63, 63, 63, 63, 101, 68, 68, 68, 62, 63, 63, 71, 71, 71,
103, 103, 103, 103, 103, 103, 103, 68, 68, 68, 71, 71, 71, 71, 71, 71